0000000000000000000000000
9111111111111111111111110
0001000100000000000010000
0001111111111000111010000
0111000000001000001010000
0001000000000000001110000
0011111121111111111000000
0000100000000100000010000
0000100000000111100010000
0011111110000100000010000
0000010010000100000010000
0001110011111111110000200
0001000000000000000000100
0001111111111111111111118
0000000000000000000000000