911111111111111111111111
000100010000000000001000
000111111111100011101000
011100000000100000101000
000100000000000000111000
001111112111111111100000
000010000000010000001000
000010000000011110001000
001111111000010000001000
000001001000010000001000
000111001111111111000020
000100000000000000000010
000111111111111111111118
000000000000000000000000